anvil=砧骨
bag=袋
barrel=桶
Barrels=桶
basket=篮子
bed=床
bedside table=床头桌
bench=工作台
big fence=大栅栏
books=书
book single=预订单曲
book single with free pages=带免费页面的单本书
bottle=瓶子
bowl=碗
box=包厢
Boxes=盒子
brick=砖
bucket=水桶
cage=监狱
candle=蜡烛
canvas on wall=墙上的画布
carpet=地毯
cauldron=大锅
chair=椅子
chair canvas=椅子帆布
chest=胸部
crate=板条箱
cupboard=衣柜
cutting board=切肉板
fence=栅栏
fence half=栅栏半
firewood=木柴
firewood no support=柴火没有支撑
firewood single=柴火单身
fork=叉
frying pan=煎锅
furnace=熔炉
gabinet=石笼网
granite panel=花岗岩面板
half tree=半棵树
hood=头巾
House=房子
house=房子
mug=马克杯
pile of planks=一堆木板
plate=盘子
platform=平台
pot=罐
rack for weapons=武器架
rack for weapons small=小型武器架
sawing wood=锯木头
scroll=卷起
scrolls=卷轴
shelf=架子
spice bag=香料包
spoon=匙
stone bridge=石桥
stone bridge column=石桥柱
stone bridge connector=石桥连接器
stone column=石柱
stone half gate=石头半门
stone half wall=石头半墙
stone half wall bottom=石头半墙底
stone half wall corner=石头半墙角
stone quarter wall=石墙
stone stairs=石阶
stone wall=石墙
stone wall detailed=石墙详图
stone wall detailed corner=石墙细节角
table=桌子
Three firewoods=三片火柴盒
torch=火炬
tower=塔
tower destroyed=塔楼被毁
tower enter=塔台入口
tower floor=塔楼地板
tower floor small=塔楼小地板
tower small=小塔
tower small destroyed=小塔楼被毁
tower small enter=塔小入口
tower small window=塔式小窗
tower stair stone=塔式楼梯石
tower stair wood=塔式楼梯木
tower window=塔楼窗户
tree=树
trunk=树干
vase=花瓶
wagon=货车
wall passage=墙壁通道
wall short=墙短
wall short no side=墙短无边
well=良好的
windbreak=防风林
windbreak expensive=防风林很贵
wood bridge=木桥
wood bridge start sloped=木桥开始倾斜
wood bridge start straight=木桥直走
wood column=木柱
wood gate=木门
wood stairs=木制楼梯
wood stairs support=木质楼梯支架
wood wall=木质墙壁
wood wall enter=木墙入口
wood wall window=木质墙窗